WWWWWWWWWWWWWWWWWWWWWWWWW
W FSSSSSSXSSESSXSSSSSSF W
WSSSSSSSSSSSSSSSSSSSSSSSW
WLLLSSSSSSSSSLLLLLLLLLLLW
WLLLLLSSSSSLLLSSSSSSSLLLW
WLLLLLSSSSSLLLSLLLLLSLLLW
WLLLLLSSSSSLLLSLLLLLSLLLW
WLLLLLSSSSSSSSSLLLLLSLLLW
WLLLLLSSSSSLLLLLLLLLSLLLW
WLLLLLSSSSSLLLLLLSSSSLLLW
WLLLLLSSSSSLLLLLLSLLLLLLW
WLLLLSSSSSSSSSLLLSSSSSSLW
WLLLLSSSSSSSSSLLLLLLLSSLW
WLLVSSSSSSSSSSSSSVLLLLLLW
WSSSSSSSSSSSSSSSSSSSLLLLW
WWWWWWWWWWWWWWWWWWWWLLLLW