WWWWWWWWWWWWWWWWWWWWWWWWW
WP     W                W
W SSSSSWSSSSSSSSSSSSSSS W
W SSSWWWSSSSSSSSSSSSSSS W
W SSSSSSSSSSSSSS  SSSSS W
W SSSSSSSSSSSSSS  SSSSS W
W SSSSSSSSSSSSSSSSSSSSSBW
W SSSSS  SSSSSSSSSSSSSS W
W SSSSS  SSSSSSSSSSSSSS W
W SSSSSSSSSSSSWWWSSSSSS W
W SSSSSSSSSSSSSSWSSSSSS W
W               W       W
WWWWWWWWWWWWWWWWWWWWWWWWW