WWWWWWWWWWWWWWWWWWWWWWWWW
WFSSSXSSNSSXSSSSSSSSSSSFW
WSSSSSSSSSSSSSSSSSSSSSSSW
WLLLSSSSSSSSSLLLLLLLLLLLW
WLLLLLSSSSSLLLSSSSSSSLLLW
WLLLLLSSSSSLLLSLLLLLSLLLW
WLLLLLSSSSSLLLSLLLLLSLLLW
WLLLLLSSSSSSSSSLLLLLSLLLW
WLLLLLSSSSSLLLLLLLLLSLLLW
WLLLLLSSSSSLLLLLLSSSSLLLW
WLLLLLSSSSSLLLLLLSLLLLLLW
WLLLLSSSSSSSSSLLLSSSSSSLW
WLLLLSSSSSSSSSLLLLLLLSSLW
WLLVSSGSSSSSSSSSSVLLLLLLW
WSSSSSSSSSSSSSSSSSSSLLLLW
WWWWWWWWWWWWWWWWWWWWLLLLW