WWWWWWWWWWWWWWWWWWWWWWWWW
W FSSSSSSXSSESSXSSSSSSF W
WSSSSSSSSSSSSSSSSSSSSSSSW
WLLLLLLLSSSSSSSSSLLLLLLLW
WLLLLLLLLLSSSSSLLLLLLLLLW
WLLLLLLLLLSSSSSLLLLLLLLLW
WLLLLLLLLLSSSSSLLLLLLLLLW
WLLLLLLLLLSSSSSLLLLLLLLLW
WLLLLLLLLLSSSSSLLLLLLLLLW
WLLLLLLLLLSSSSSLLLLLLLLLW
WLLLLLLLLLSSSSSLLLLLLLLLW
WLLLLLLLSSSSSSSSSLLLLLLLW
WLLLLLLLSSSSSSSSSLLLLLLLW
WLLLLVSSSSSSSSSSSSSVLLLLW
WLLSSSSSSSSSSSSSSSSSSSLLW
WLLWWWWWWWWWWWWWWWWWWWLLW